8, 10
%%%%%%%%
%----S--
%-%-%-%-
%-%%---%
%-%---%-
%-%-%-%-
%-----%-
%-%-%-%-
%-G--%--
%%%%%%%%
